AP	AP
SP	SP
br	br
cl	cl
vf	vf
a	a
i	i
u	u
e	e
o	o
N	N
k	k
ky	ky
s	s
sh	sh
t	t
h	h
hy	hy
g	g
gy	gy
z	z
d	d
dy	dy
b	b
by	by
p	p
py	py
j	j
f	f
ch	ch
ts	ts
n	n
ny	ny
m	m
my	my
r	r
ry	ry
y	y
w	w
ty	ty